R 5000 4000
F 122,122,122
NO             ./textures/bob.xpm
WE   ./textures/anime.xpm


























EA ./textures/fuhrer.xpm
S ./textures/slavane.xpm
SO ./textures/wood.xpm
C 123,34,55

        1111111111111111111111111
111111111011000001110000000000001
100000000011000001110111111111111
11110111111111011100000022001
11110111111111011101010022001
11000000110101011100000022001
10002000000000001100000010001
10000000000000001101010010001
11000001110101011111011110N0111
11110111111101011101111010001
11111111111111111111111111111