R         800 0










F 1,32,012
NO             ./textures/bob.xpm
WE ./textures/anime.xpm
EA ./textures/anime.xpm
S ./textures/slavane.xpm
SO ./textures/wood.xpm
C 13,32,100





















1111111111111111111111
1000000000000000000001           111111
1000222222222222222001           1111111
1000222222222222222001111111111111100001
1000000000000000000000000000000000000001
100000000000N000000001111111111111111111
1000000000000000000001
1000222222222222222001
1111111111111111111111
                      
1111111111111111111111
1000222222222222222001
1000000000000000000001
1000000000000000000001
1000000000000000000001
1000000000000000000001
1000000000000000000001
1000000000000000000001
1111111111111111111111
