R 200 300
F 122,122,122
NO             ./textures/bob.xpm
WE   ./textures/anime.xpm

EA ./textures/wood.xpm
S ./textures/slavane.xpm
SO ./textures/wood.xpm
C 123,34,55

        1111111111111111111111111111111
1111111110110000011100000000000011111110
100000000110000011101111111111111    11
11110111111111011100000022001
11110111111111011101010022001
11000000110101011100000022001111111111     1111
10002000000000110000001001111111111111111111N01
100000000000000011010100100011111111111111 1111
11000001110101011111011110001
11110111111101011101111010001
111111111111111111111111111111