R 100000 12341235413534523145324543252345234534
F 122,122,122
NO             ./textures/bluestone.xpm
WE   ./textures/anime.xpm
EA ./textures/eagle.xpm
S ./textures/slavane.xpm
SO ./textures/wood.xpm
C 123,34,55

1111111111111111111111111111111111
111111111011000001110000000000001
100000000011000001110000001111111
11110111111111011100000010001
11110111111111011101010000001
11000000110101011100000000001
10002000000000001100000000001
10000000000000001101010000001
11000001110101011111011110N0111
11110111 1110101 101111010001
11111111 1111111 111111111111