R 200 300
F 122,122,122
NO             ./textures/bob.xpm
WE   ./textures/anime.xpm

EA ./textures/wood.xpm
S ./textures/slavane.xpm
SO ./textures/wood.xpm
C 123,34,55

        1111111111111111111111111111111111
111111111011000001110000000000001111111021
100000000110000011101111111111111    11111
11110111111111011100000022001
11110111111111011101010022001
11000000110101011100000022001111111111      1              
10002000000000110000001001111111111111111111N 
100000000000000011010100100011111111111111  1                  
11000001110101011111011110001
11110111111101011101111010001
111111111111111111111111111111