R 800 800
F 122,122,122
NO             ./textures/bob.xpm
WE   ./textures/anime.xpm
EA ./textures/fuhrer.xpm
S ./textures/slavane.xpm
SO ./textures/wood.xpm
C 123,34,55


            1111111111111111111111
            1000000000000000000001           111111
            1000222222222222222001           1111111
            10002222222222222220011111111 1111100001
            10000000001110000000000000001 1000000001
            1000000S001 10000000011111111 1111111111
            1000000000111000000001
            1000222222222222222001
            1111111111111111111111
            1000222222222222222001
            1000000000000000000001
            1000000000000000000001
            1000000000000000000001
            1000000000000000000001
            1000000000000000000001
            1000000000000000000001
            1111111111111111111111
