R 000800 000500
F 233, 27, 253
NO ./eagle.xpm
WE ./1.xpm
EA ./2.xpm
S ./barrel.xpm
SO wood.xpm
C 233, 163, 4

111111111111111
1002100S0022001
100000000002001
100000111002001
100200011000001
100020011002001
111111111111111