R 0001000 00300
F 233, 27, 253
NO ./textures/eagle.xpm
WE ./textures/1.xpm
EA ./textures/2.xpm
S ./textures/barrel.xpm
SO ./textures/wood.xpm
C 233, 163, 4

111111111111111
1002100S0022001
100000000002001
100000111002001
100200011000001
100020011002001
111111111111111