R 640 480 
F 123,104,238
NO ./eagle.xpm
WE ./4.xpm
EA ./5.xpm
S ./eagle.xpm
SO ./wood.xpm
C 122,200,39

111111111111111
100010000000001
100000000000001
1000W0111000001
100000011000001
100000011000001
111111111111111