R 000014000 0003000
F 123,123,238
NO ./eagle.xpm
WE ./1.xpm
EA ./2.xpm
S ./barrel.xpm
SO ./wood.xpm
C 122,200,39

111111111111111
1002100S0022001
100000000002001
100000111002001
100200011000001
100020011002001
111111111111111