R  200 300
F 233, 27, 253
NO ./textures/eagle.xpm
WE ./textures/1.xpm
EA ./textures/2.xpm
S ./textures/barrel.xpm
SO ./textures/wood.xpm
C 233, 163, 4


111111111
100000001
100020001
100000201
100000001
111111111