                                R  800 800
F 113,                                103, 255                      
NO ./textures/1.xpm
WE ./textures/1.xpm
EA ./textures/2.xpm
S ./textures/barrel.xpm
SO ./textures/wood.xpm
C 233, 163, 4


 111111111
 100020201            1111
 1000000111                                 
 1000N00011 
 111011111  111111f11111
111011 1111      
 11221
 11111
                      