R 240 320












                                    F 123,104,238





NO                        ./eagle.xpm







WE ./wood.xpm








EA ./wood.xpm







S ./pillar.xpm

SO ./barrel.xpm
C 122,200,39

111111111111111
10001000022000111111111
10000000000200111111111
1000W011100200111111111
10020001100000111111111
10002001100000111111111
111111111111111