    R 00001000 00000000000100
F 113,                                103, 255                      
NO ./textures/1.xpm
WE ./textures/1.xpm
EA ./textures/2.xpm
S ./textures/barrel.xpm
SO ./textures/wood.xpm
C 233, 163, 4






 111111111
 100020201            11111111
 1000000111             100001                    
 1000N00011             111111
 111011111  111111111111                  1
111011 1111      
 11221
 11111