R 640 480
F 123,104,238
NO ./parse_mod.c
WE parse_mod.c
EA parse_mod.c
S parse_mod.c
SO parse_mod.c
C 122,200,39

111111111111111
100000000000001
100000000000001
100000011000001
100000001100001
100000000000001
111111111111111