                                R  1440 1000
F 113,                                103, 255                      
NO ./textures/1.xpm
WE ./textures/1.xpm
EA ./textures/2.xpm
S ./textures/barrel.xpm
SO ./textures/wood.xpm
C 233, 163, 4


1111111111
1000202011
1000000011
1000N00001
1111111111