R 640 480
F 123,104,238
NO ./eagle.xpm
WE ./4.xpm
EA ./5.xpm
S ./pillar.xpm
SO ./barrel.xpm
C 122,200,39

111111111111111
100010000220001
100000000002001
1000W0111002001
100200011000001
100020011000001
111111111111111