    R 800 800
F 113,                                103, 255                      
NO ./textures/1.xpm
WE ./textures/1.xpm
EA ./textures/2.xpm
S ./textures/barrel.xpm
SO ./textures/wood.xpm
C 233, 100, 1

 111111111
 100222001
 10000N001
 100000001
 111111111