R 640 480 
F 123,104,238
NO ./eagle.xpm
WE ./4.xpm
EA ./5.xpm
S ./barrel.xpm
SO ./wood.xpm
C 122,200,39

111111111111111
100210000022001
100000000002001
1000W0111002001
100200011000001
100020011002001
111111111111111