R 300 400
F 100,200,39
NO ./parse_mod.c
WE parse_mod.c
EA parse_mod.c
S parse_mod.c
SO parse_mod.c
C 122,200,39

        1111111111 11111111111111
        1000000001 10000000000001
        1111000001110000002000001
        1001000000000000000000001
111111111011000001110000000000001
100000000011000001110111111111111
11110111111111011100000010001
11110111111111011101010010001
11000000110101011100000010001
10002000000000001100000010001
10000000000000001101010010001
11000001110101011111011110N0111
11110111 1110101 101111010001
11111111 1111111 111111111111