R  800 400
F 233, 27, 253
NO ./textures/eagle.xpm
WE ./textures/1.xpm
EA ./textures/2.xpm
S ./textures/barrel.xpm
SO ./textures/wood.xpm
C 233, 163, 4

11111111111111111111
1002100S002200111111
10000000000200111111
100000111002001
100200011000001
100020011002001
111111111111111