R  800 400
F 233, 27, 253
NO ./textures/eagle.xpm
WE ./textures/1.xpm
EA ./textures/2.xpm











S ./textures/barrel.xpm
SO ./textures/wood.xpm
C 233, 163, 4

111111111111111111
1002100S0022001111
1000000000020011111
100000111002001
100200011000001
100020011112001
111111111111111