R 400 300
F 113, 103, 108
NO ./textures/eagle.xpm
WE ./textures/1.xpm
EA              ./textures/2.xpm
S ./textures/barrel.xpm
SO ./textures/wood.xpm
C             233,            163, 4

111111111111111111111111111111111111111111111111111111111111111111111111111111111111111111111111111111111111111111111111111111111111111111111111111111111
100000000000000000000000000000000222222222222222220222222222222222222222222220222222222222222222220222222222222222222220222222222222222220000000000000001
100000000000000000000000000000000222222222222222220222222222222222222222222220222222222222222222220222222222222222222220222222222222222220000000000000001
100000000000000000000000000000000222222222222222220222222222222222222222222220222222222222222222220222222222222222222220222222222222222220000000000000001
100000000000000000000000000000000222222222222222220222222222222222222222222220222222222222222222220222222222222222222220222222222222222220000000000000001
100000000000000000000000000000000222222222222222220222222222222222222222222220222222222222222222220222222222222222222220222222222222222220000000000000001
100000000000000000000000000000000222222222222222220222222222222222222222222220222222222222222222220222222222222222222220222222222222222220000000000000001
100000000000000000000000000000000222222222222222220222222222222222222222222220222222222222222222220222222222222222222220222222222222222220000000000000001
100000000000000000000000000000000222222222222222220222222222222222222222222220222222222222222222220222222222222222222220222222222222222220000000000000001
100000000000000000000000000000000222222222222222220222222222222222222222222220222222222222222222220222222222222222222220222222222222222220000000000000001
100000000000000000000000000000000222222222222222220222222222222222222222222220222222222222222222220222222222222222222220222222222222222220000000000000001
100000000000000000000000000000000222222222222222220222222222222222222222222220222222222222222222220222222222222222222220222222222222222220000000000000001
100000000000000000000000000000000222222222222222220222222222222222222222222220222222222222222222220222222222222222222220222222222222222220000000000000001
100000000000000000000000000000000222222222222222220222222222222222222222222220222222222222222222220222222222222222222220222222222222222220000000000000001
100000000000000000000000000000000222222222222222220222222222222222222222222220222222222222222222220222222222222222222220222222222222222220000000000000001
100000000000000000000000000000000222222222222222220222222222222222222222222220222222222222222222220222222222222222222220222222222222222220000000000000001
100000000000000000000000000000000222222222222222220222222222222222222222222220222222222222222222220222222222222222222220222222222222222220000000000000001
100000000000000000000000000000000222222222222222220222222222222222222222222220222222222222222222220222222222222222222220222222222222222220000000000000001
100000000000000000000000000000000222222222222222220222222222222222222222222220222222222222222222220222222222222222222220222222222222222220000000000000001
100000000000000000000000000000000222222222222222220222222222222222222222222220222222222222222222220222222222222222222220222222222222222220000000000000001
100000000000000000000000000000000222222222222222220222222222222222222222222220222222222222222222220222222222222222222220222222222222222220000000000000001
100000000000000000000000000000000222222222222222220222222222222222222222222220222222222222222222220222222222222222222220222222222222222220000000000000001
100000000000000000000000000000000222222222222222220222222222222222222222222220222222222222222222220222222222222222222220222222222222222220000000000000001
100000000000000000000000000000000222222222222222220222222222222222222222222220222222222222222222220222222222222222222220222222222222222220000000000000001
100000000000000000000000000000000222222222222222220222222222222222222222222220222222222222222222220222222222222222222220222222222222222220000000000000001
100000000000000000000000000000000222222222222222220222222222222222222222222220222222222222222222220222222222222222222220222222222222222220000000000000001
100000000000000000000000000000000222222222222222220222222222222222222222222220222222222222222222220222222222222222222220222222222222222220000000000000001
100000000000000000000000000000000222222222222222220222222222222222222222222220222222222222222222220222222222222222222220222222222222222220000000000000001
100000000000000000000000000000000222222222222222220222222222222222222222222220222222222222222222220222222222222222222220222222222222222220000000000000001
100000000000000000000000000000000222222222222222220222222222222222222222222220222222222222222222220222222222222222222220222222222222222220000000000000001
100000000000000000000000000000000222222222222222220222222222222222222222222220222222222222222222220222222222222222222220222222222222222220000000000000001
100000000000000000000000000000000222222222222222220222222222222222222222222220222222222222222222220222222222222222222220222222222222222220000000000000001
100000000000000000000000000000000222222222222222220222222222222222222222222220222222222222222222220222222222222222222220222222222222222220000000000000001
100000000000000000000000000000000222222222222222220222222222222222222222222220222222222222222222220222222222222222222220222222222222222220000000000000001
100000000000000000000000000000000222222222222222220222222222222222222222222220222222222222222222220222222222222222222220222222222222222220000000000000001
100000000000000000000000000000000222222222222222220222222222222222222222222220222222222222222222220222222222222222222220222222222222222220000000000000001
100000000000000000000000000000000222222222222222220222222222222222222222222220222222222222222222220222222222222222222220222222222222222220000000000000001
100000000000000000000000000000000222222222222222220222222222222222222222222220222222222222222222220222222222222222222220222222222222222220000000000000001
100000000000000000000000000000000222222222222222220222222222222222222222222220222222222222222222220222222222222222222220222222222222222220000000000000001
100000000000000000000000000000000222222222222222220222222222222222222222222220222222222222222222220222222222222222222220222222222222222220000000000000001
100000000000000000000000000000000222222222222222220222222222222222222222222220222222222222222222220222222222222222222220222222222222222220000000000000001
100000000000000000000000000000000222222222222222220222222222222222222222222220222222222222222222220222222222222222222220222222222222222220000000000000001
100000000000000000000000000000000222222222222222220222222222222222222222222220222222222222222222220222222222222222222220222222222222222220000000000000001
100000000000000000000000000000000222222222222222220222222222222222222222222220222222222222222222220222222222222222222220222222222222222220000000000000001
100000000000000000000000000000000222222222222222220222222222222222222222222220222222222222222222220222222222222222222220222222222222222220000000000000001
100000000000000000000000000000000222222222222222220222222222222222222222222220222222222222222222220222222222222222222220222222222222222220000000000000001
100000000000000000000000000000000222222222222222220222222222222222222222222220222222222222222222220222222222222222222220222222222222222220000000000000001
100000000000000000000000000000000222222222222222220222222222222222222222222220222222222222222222220222222222222222222220222222222222222220000000000000001
100000000000000000000000000000000222222222222222220222222222222222222222222220222222222222222222220222222222222222222220222222222222222220000001111111111
100000000000000000000000000000000222222222222222220222222222222222222222222220222222222222222222220222222222222222222220222222222222222220000001
100000000000000000000000000000000222222222222222220222222222222222222222222220222222222222222222220222222222222222222220222222222222222220000001111111111
100000000000000000000000000000000222222222222222220222222222222222222222222220222222222222222222220222222222222222222220222222222222222220000001111111111
100000000000000000000000000000000222222222222222220222222222222222222222222220222222222222222222220222222222222222222220222222222222222220000001111111111
100000000000000000000000000000000222222222222222220222222222222222222222222220222222222222222222220222222222222222222220222222222222222220000000000000001
100000000000000000000000000000000222222222222222220222222222222222222222222220222222222222222222220222222222222222222220222222222222222220000000000000001
100000000000000000000000000000000222222222222222220222222222222222222222222220222222222222222222220222222222222222222220222222222222222220000000000000001
100000000000000000000000000000000222222222222222220222222222222222222222222220222222222222222222220222222222222222222220222222222222222220000000000000001
100000000000000000000000000000000222222222222222220222222222222222222222222220222222222222222222220222222222222222222220222222222222222220000000000000001
100000000000000000000000000000000222222222222222220222222222222222222222222220222222222222222222220222222222222222222220222222222222222220000000000000001
100000000000000000000000000000000222222222222222220222222222222222222222222220222222222222222222220222222222222222222220222222222222222220000000000000001
100000000000000000000000000000000222222222222222220222222222222222222222222220222222222222222222220222222222222222222220222222222222222220000000000000001
100000000000000000000000000000000222222222222222220222222222222222222222222220222222222222222222220222222222222222222220222222222222222220000000000000001
100000000000000000000000000000000222222222222222220222222222222222222222222220222222222222222222220222222222222222222220222222222222222220000000000000001
100000000000000000000000000000000222222222222222220222222222222222222222222220222222222222222222220222222222222222222220222222222222222220000000000000001
100000000000000000000000000000000222222222222222220222222222222222222222222220222222222222222222220222222222222222222220222222222222222220000000000000001
100000000000000000000000000000000222222222222222220222222222222222222222222220222222222222222222220222222222222222222220222222222222222220000000000000001
100000000000000000000000000000000222222222222222220222222222222222222222222220222222222222222222220222222222222222222220222222222222222220000000000000001
100000000000000000000000000000000222222222222222220222222222222222222222222220222222222222222222220222222222222222222220222222222222222220000000000000001
100000000000000000000000000000000222222222222222220222222222222222222222222220222222222222222222220222222222222222222220222222222222222220000000000000001
100000000000000000000000000000000222222222222222220222222222222222222222222220222222222222222222220222222222222222222220222222222222222220000000000000001
100000000000000000000000000000000222222222222222220222222222222222222222222220222222222222222222220222222222222222222220222222222222222220000000000000001
100000000000000000000000000000000222222222222222220222222222222222222222222220222222222222222222220222222222222222222220222222222222222220000000000000001
100000000000000000000000000000000222222222222222220222222222222222222222222220222222222222222222220222222222222222222220222222222222222220000000000000001
100000000000000000000000000000000222222222222222220222222222222222222222222220222222222222222222220222222222222222222220222222222222222220000000000000001
100000000000000000000000000000000222222222222222220222222222222222222222222220222222222222222222220222222222222222222220222222222222222220000000000000001
100000000000000000000000000000000222222222222222220222222222222222222222222220222222222222222222220222222222222222222220222222222222222220000000000000001
100000000000000000000000000000000222222222222222220222222222222222222222222220222222222222222222220222222222222222222220222222222222222220000000000000001
100000000000000000000000000000000222222222222222220222222222222222222222222220222222222222222222220222222222222222222220222222222222222220000000000000001
100000000000000000000000000000000222222222222222220222222222222222222222222220222222222222222222220222222222222222222220222222222222222220000000000000001
100000000000000000000000000000000222222222222222220222222222222222222222222220222222222222222222220222222222222222222220222222222222222220000000000000001
100000000000000000000000000000000222222222222222220222222222222222222222222220222222222222222222220222222222222222222220222222222222222220000000000000001
100000000000000000000000000000000222222222222222220222222222222222222222222220222222222222222222220222222222222222222220222222222222222220000000000000001
100000000000000000000000000000000222222222222222220222222222222222222222222220222222222222222222220222222222222222222220222222222222222220000000000000001
100000000000000000000000000000000222222222222222220222222222222222222222222220222222222222222222220222222222222222222220222222222222222220000000000000001
100000000000000000000000000000000222222222222222220222222222222222222222222220222222222222222222220222222222222222222220222222222222222220000000000000001
100000000000000000000000000000000222222222222222220222222222222222222222222220222222222222222222220222222222222222222220222222222222222220000000000000001
100000000000000000000000000000000222222222222222220222222222222222222222222220222222222222222222220222222222222222222220222222222222222220000000000000001
100000000000000000000000000000000222222222222222220222222222222222222222222220222222222222222222220222222222222222222220222222222222222220000000000000001
100000000000000000000000000000000222222222222222220222222222222222222222222220222222222222222222220222222222222222222220222222222222222220000000000000001
100000000000000000000000000000000222222222222222220222222222222222222222222220222222222222222222220222222222222222222220222222222222222220000000000000001
100000000000000000000000000000000222222222222222220222222222222222222222222220222222222222222222220222222222222222222220222222222222222220000000000000001
100000000000000000000000000000000222222222222222220222222222222222222222222220222222222222222222220222222222222222222220222222222222222220000000000000001
100000000000000000000000000000000222222222222222220222222222222222222222222220222222222222222222220222222222222222222220222222222222222220000000000000001
100000000000000000000000000000000222222222222222220222222222222222222222222220222222222222222222220222222222222222222220222222222222222220000000000000001
100000000000000000000000000000000222222222222222220222222222222222222222222220222222222222222222220222222222222222222220222222222222222220000000000000001
100000000000000000000000000000000222222222222222220222222222222222222222222220222222222222222222220222222222222222222220222222222222222220000000000000001
100000000000000000000000000000000222222222222222220222222222222222222222222220222222222222222222220222222222222222222220222222222222222220000000000000001
100000000000000000000000000000000222222222222222220222222222222222222222222220222222222222222222220222222222222222222220222222222222222220000000000000001
100000000000000000000000000000000222222222222222220222222222222222222222222220222222222222222222220222222222222222222220222222222222222220000000000000001
100000000000000000000000000000000222222222222222220222222222222222222222222220222222222222222222220222222222222222222220222222222222222220000000000000001
100000000000000000000000000000000222222222222222220222222222222222222222222220222222222222222222220222222222222222222220222222222222222220000000000000001
100000000000000000000000000000000222222222222222220222222222222222222222222220222222222222222222220222222222222222222220222222222222222220000000000000001
100000000000000000000000000000000222222222222222220222222222222222222222222220222222222222222222220222222222222222222220222222222222222220000000000000001
100000000000000000000000000000000222222222222222220222222222222222222222222220222222222222222222220222222222222222222220222222222222222220000000000000001
100000000000000000000000000000000222222222222222220222222222222222222222222220222222222222222222220222222222222222222220222222222222222220000000000000001
100000000000000000000000000000000222222222222222220222222222222222222222222220222222222222222222220222222222222222222220222222222222222220000000000000001
100000000000000000000000000000000222222222222222220222222222222222222222222220222222222222222222220222222222222222222220222222222222222220000000000000001
100000000000000000000000000000000222222222222222220222222222222222222222222220222222222222222222220222222222222222222220222222222222222220000000000000001
100000000000000000000000000000000222222222222222220222222222222222222222222220222222222222222222220222222222222222222220222222222222222220000000000000001
100000000000000000000000000000000222222222222222220222222222222222222222222220222222222222222222220222222222222222222220222222222222222220000000000000001
100000000000000000000000000000000222222222222222220222222222222222222222222220222222222222222222220222222222222222222220222222222222222220000000000000001
100000000000000000000000000000000222222222222222220222222222222222222222222220222222222222222222220222222222222222222220222222222222222220000000000000001
100000000000000000000000000000000222222222222222220222222222222222222222222220222222222222222222220222222222222222222220222222222222222220000000000000001
100000000000000000000000000000000222222222222222220222222222222222222222222220222222222222222222220222222222222222222220222222222222222220000000000000001
100000000000000000000000000000000222222222222222220222222222222222222222222220222222222222222222220222222222222222222220222222222222222220000000000000001
100000000000000000000000000000000222222222222222220222222222222222222222222220222222222222222222220222222222222222222220222222222222222220000000000000001
100000000000000000000000000000000222222222222222220222222222222222222222222220222222222222222222220222222222222222222220222222222222222220000000000000001
100000000000000000000000000000000222222222222222220222222222222222222222222220222222222222222222220222222222222222222220222222222222222220000000000000001
100000000000000000000000000000000222222222222222220222222222222222222222222220222222222222222222220222222222222222222220222222222222222220000000000000001
100000000000000000000000000000000222222222222222220222222222222222222222222220222222222222222222220222222222222222222220222222222222222220000000000000001
100000000000000000000000000000000222222222222222220222222222222222222222222220222222222222222222220222222222222222222220222222222222222220000000000000001
100000000000000000000000000000000222222222222222220222222222222222222222222220222222222222222222220222222222222222222220222222222222222220000000000000001
100000000000000000000000000000000222222222222222220222222222222222222222222220222222222222222222220222222222222222222220222222222222222220000000000000001
100000000000000000000000000000000222222222222222220222222222222222222222222220222222222222222222220222222222222222222220222222222222222220000000000000001
100000000000000000000000000000000222222222222222220222222222222222222222222220222222222222222222220222222222222222222220222222222222222220000000000000001
100000000000000000000000000000000222222222222222220222222222222222222222222220222222222222222222220222222222222222222220222222222222222220000000000000001
100000000000000000000000000000000222222222222222220222222222222222222222222220222222222222222222220222222222222222222220222222222222222220000000000000001
100000000000000000000000000000000222222222222222220222222222222222222222222220222222222222222222220222222222222222222220222222222222222220000000000000001
100000000000000000000000000000000222222222222222220222222222222222222222222220222222222222222222220222222222222222222220222222222222222220000000000000001
100000000000000000000000000000000222222222222222220222222222222222222222222220222222222222222222220222222222222222222220222222222222222220000000000000001
100000000000000000000000000000000222222222222222220222222222222222222222222220222222222222222222220222222222222222222220222222222222222220000000000000001
100000000000000000000000000000000222222222222222220222222222222222222222222220222222222222222222220222222222222222222220222222222222222220000000000000001
100000000000000000000000000000000222222222222222220222222222222222222222222220222222222222222222220222222222222222222220222222222222222220000000000000001
100000000000000000000000000000000222222222222222220222222222222222222222222220222222222222222222220222222222222222222220222222222222222220000000000000001
100000000000000000000000000000000000000000000000000000000000000000000000000000000000000000000000000000000000000000000000000000000000000000000000000000001
100000000000000000000000000000000000000000000000000000000000000000000000000000000000000000000000000000000000000000000000000000000000000000000000000000001
100000000000000000000000000000000000000000000000000000000000000000000000000000000000000000000000000000000000000000000000000000000000000000000000000000001
100000000000000000000000000000000000000000000000000000000000000000000000000000N00000000000000000000000000000000000000000000000000000000000000000000000001
111111111111111111111111111111111111111111111111111111111111111111111111111111111111111111111111111111111111111111111111111111111111111111111111111111111
