R 3000 3000
F 113, 103, 108
NO ./textures/eagle.xpm
WE ./textures/1.xpm
EA              ./textures/2.xpm
S ./textures/barrel.xpm
SO ./textures/wood.xpm
C             233,            163, 4

111111111111111111
11002100S0022001111
11002100S0022001111
111111000000000000111
1100000000020011111
100000111002001
100200011000001
10002001111200111111111
1111111111111111111111